period,natural_gas_price,crude_oil_price,elec_demand,elec_dayahead_demand_forecast,elec_net_generation,elec_total_interchange,elec_spot_price
2019-01-02,3.25,46.31,341608,338210,274747,-66861,30.94
2019-01-03,2.72,46.92,342582,341030,273544,-69038,29.12
2019-01-04,2.8,47.76,329108,326720,256387,-72721,40.73
2019-01-07,2.74,48.27,361207,359990,282012,-79195,31.46
2019-01-08,2.89,49.58,354933,357570,277864,-77069,31.71
2019-01-09,2.92,52.19,342763,336600,263592,-79171,49.8
2019-01-10,2.95,52.42,355403,351860,275619,-79784,60.74
2019-01-11,2.95,51.44,367458,365540,286371,-81087,49.27
2019-01-14,3.36,50.31,371489,369210,291791,-79698,61.16
2019-01-15,3.54,51.8,366098,360950,284400,-81698,62.08
2019-01-16,3.58,52.08,369143,352060,285329,-83814,94.42
2019-01-17,3.58,51.83,365587,365110,280529,-85058,77.47
2019-01-18,3.43,53.6,355096,355540,274909,-80187,124.87
2019-01-21,3.43,51.83,420726,412460,359915,-60811,108.0
2019-01-22,3.43,52.59,410659,411980,345274,-65385,50.93
2019-01-23,3.13,52.44,382468,374560,307507,-74961,39.54
2019-01-24,3.13,52.94,349656,343040,261488,-88168,61.62
2019-01-25,3.07,53.53,343501,337790,254011,-89490,64.34
2019-01-28,3.05,51.79,354008,348070,263017,-90991,69.86
2019-01-29,2.94,53.07,376080,371490,287666,-88414,93.53
2019-01-30,3.0,54.18,369692,366730,291318,-78374,107.04
2019-01-31,2.82,53.84,411954,413380,347844,-64110,60.13
2019-02-01,2.7,55.29,401447,394910,344986,-56461,40.0
2019-02-04,2.57,54.57,326591,320010,247422,-79169,29.94
2019-02-05,2.54,53.69,319651,314560,251030,-68621,33.25
2019-02-06,2.58,53.94,324558,323250,257326,-67232,27.14
2019-02-07,2.62,52.68,339696,339150,265934,-73762,27.06
2019-02-11,2.76,52.43,351808,345050,272112,-79696,45.64
2019-02-12,2.71,53.14,376917,374590,303207,-73710,34.0
2019-02-13,2.61,53.84,351044,349970,270508,-80536,32.22
2019-02-14,2.61,54.4,344810,337800,270577,-74233,28.08
2019-02-19,2.69,56.12,368123,361230,297648,-70475,34.25
2019-02-20,2.69,56.9,373103,369740,306434,-66669,28.48
2019-02-21,2.73,56.95,344993,342160,281342,-63651,31.67
2019-02-25,2.84,55.32,344296,333960,263831,-80465,53.05
2019-02-26,2.74,55.4,359841,347570,278595,-81246,55.32
2019-02-27,2.89,56.92,375446,372190,298548,-76898,51.28
2019-02-28,2.89,57.21,366823,366620,290721,-76102,46.36
2019-03-04,4.25,56.6,346633,335930,287516,-59117,74.68
2019-03-05,3.18,56.55,352627,345260,292604,-60023,76.29
2019-03-06,3.18,56.22,363383,355830,307792,-55591,56.07
2019-03-07,2.9,56.6,371570,365870,315479,-56091,41.0
2019-03-11,2.86,56.79,321147,312370,260458,-60689,35.41
2019-03-12,2.83,56.89,322526,321020,263908,-58618,33.22
2019-03-13,2.87,58.27,324082,318310,260432,-63650,30.82
2019-03-14,2.95,58.59,313540,311770,253538,-60002,28.39
2019-03-15,2.95,58.51,306807,301840,250875,-55932,38.07
2019-03-18,2.9,59.09,318568,312860,271946,-46622,36.17
2019-03-19,2.92,59.12,319411,313650,272581,-46830,33.73
2019-03-20,2.86,60.12,312854,306010,260949,-51905,33.13
2019-03-21,2.86,59.98,318275,312570,269238,-49037,32.63
2019-03-22,2.75,58.87,320743,318920,269855,-50888,35.5
2019-03-25,2.72,58.71,295891,295260,256877,-39014,34.72
2019-03-26,2.74,59.87,303153,302030,267042,-36111,31.52
2019-03-27,2.69,59.39,306931,304220,273496,-33435,27.88
2019-03-28,2.69,59.29,304707,297810,260577,-44130,26.25
2019-03-29,2.73,60.19,301076,299920,251900,-49176,33.57
2019-04-01,2.73,61.59,295699,293670,257943,-37756,29.75
2019-04-03,2.74,62.46,292994,289550,248713,-44281,28.14
2019-04-04,2.66,62.12,292833,286110,251804,-41029,31.22
2019-04-05,2.62,63.1,303611,301000,263221,-40390,30.84
2019-04-08,2.72,64.37,307215,300530,273036,-34179,36.71
2019-04-09,2.71,64.05,312118,308340,271439,-40679,37.54
2019-04-10,2.72,64.62,304054,297980,260386,-43668,32.81
2019-04-11,2.72,63.61,297311,287730,251821,-45490,31.95
2019-04-12,2.75,63.86,299238,300160,249509,-49729,34.58
2019-04-15,2.75,63.43,283327,283630,234681,-48646,28.0
2019-04-16,2.66,64.01,276404,271470,227278,-49126,31.68
2019-04-17,2.55,63.74,271368,267190,221133,-50235,29.29
2019-04-18,2.54,64.02,299253,291880,252344,-46909,24.04
2019-04-22,2.61,65.66,285365,278230,244131,-41234,27.7
2019-04-23,2.53,66.24,283749,279200,241278,-42471,26.21
2019-04-24,2.53,65.96,277901,273380,240755,-37146,25.83
2019-04-25,2.54,65.23,269556,268060,231990,-37566,27.48
2019-04-26,2.58,63.29,292376,287100,252377,-39999,27.06
2019-04-29,2.58,63.39,280865,274650,234683,-46182,28.63
2019-04-30,2.59,63.83,292354,290330,246907,-45447,28.15
2019-05-01,2.59,63.55,290091,291360,243649,-46442,30.3
2019-05-02,2.63,61.75,291485,288710,247790,-43695,28.18
2019-05-06,2.54,62.3,272357,272760,219295,-53062,25.95
2019-05-07,2.54,61.41,275333,274780,221221,-54112,24.07
2019-05-08,2.64,62.13,267463,266350,211042,-56421,24.32
2019-05-09,2.62,61.58,269622,266700,215682,-53940,26.27
2019-05-10,2.64,61.65,287285,282810,237021,-50264,27.7
2019-05-13,2.71,60.97,289682,284770,241265,-48417,29.08
2019-05-14,2.7,61.82,298428,294270,243703,-54725,25.9
2019-05-15,2.69,62.03,281089,280160,226830,-54259,24.16
2019-05-16,2.62,62.93,273810,273840,217134,-56676,24.87
2019-05-17,2.61,62.77,284866,280550,227554,-57312,29.96
2019-05-20,2.7,63.12,309968,310710,261208,-48760,25.58
2019-05-21,2.73,63.02,278202,276590,231374,-46828,24.65
2019-05-22,2.73,61.42,272238,268700,216053,-56185,25.41
2019-05-23,2.56,57.65,283819,278710,223739,-60080,24.35
2019-05-28,2.65,58.91,288399,286270,233789,-54610,25.84
2019-05-29,2.69,58.84,286845,280790,231951,-54894,27.23
2019-05-30,2.69,56.47,285547,281830,231593,-53954,24.48
2019-06-03,2.5,53.25,278179,272430,217042,-61137,24.0
2019-06-04,2.45,53.5,281224,272220,231409,-49815,26.7
2019-06-05,2.45,51.57,302754,298260,247904,-54850,28.7
2019-06-06,2.4,52.59,323122,318350,276116,-47006,25.38
2019-06-10,2.42,53.33,309001,298560,248745,-60256,24.99
2019-06-11,2.41,53.3,320959,320540,259052,-61907,24.48
2019-06-12,2.43,51.13,300718,296130,235293,-65425,24.25
2019-06-13,2.43,52.38,291210,293930,240141,-51069,22.86
2019-06-14,2.37,52.47,283346,282270,221747,-61599,28.85
2019-06-17,2.46,51.94,316896,314620,259288,-57608,24.9
2019-06-18,2.44,53.86,319597,322620,256357,-63240,24.28
2019-06-19,2.43,53.74,321749,321840,257612,-64137,24.68
2019-06-20,2.38,56.88,329069,328930,266202,-62867,24.07
2019-06-21,2.27,57.35,318462,316660,250671,-67791,26.75
2019-06-24,2.31,57.73,334779,332590,267990,-66789,24.43
2019-06-25,2.31,57.63,340476,340530,282562,-57914,28.51
2019-06-26,2.34,59.17,358088,349920,301795,-56293,28.01
2019-06-27,2.32,59.18,361026,355140,313395,-47631,28.13
2019-07-01,2.33,58.91,350268,341630,284627,-65641,28.29
2019-07-02,2.3,56.0,367723,366350,310590,-57133,31.09
2019-07-03,2.29,57.06,394305,393670,335823,-58482,29.37
2019-07-08,2.39,57.35,349052,345400,296768,-52284,28.36
2019-07-09,2.41,57.57,376899,369030,318225,-58674,36.91
2019-07-10,2.49,60.28,400628,391260,336550,-64078,39.98
2019-07-11,2.54,59.93,402994,394450,332117,-70877,40.42
2019-07-12,2.54,59.99,409499,408070,332408,-77091,39.25
2019-07-15,2.53,59.3,389981,381270,328068,-61913,36.97
2019-07-16,2.53,57.44,400416,393630,329480,-70936,43.13
2019-07-17,2.44,56.5,445554,438440,370630,-74924,31.1
2019-07-18,2.38,55.08,388631,390960,309709,-78922,42.8
2019-07-19,2.3,55.42,412758,413880,336856,-75902,35.5
2019-07-22,2.33,55.87,424656,429290,349249,-75407,27.33
2019-07-23,2.34,56.58,346135,347430,280980,-65155,26.68
2019-07-24,2.33,55.9,352848,344840,275941,-76907,28.17
2019-07-25,2.26,55.88,360392,353570,287339,-73053,29.98
2019-07-26,2.23,56.04,378804,369580,309264,-69540,38.13
2019-07-29,2.23,56.85,460244,446140,384504,-75740,47.14
2019-07-30,2.22,58.04,478639,472200,398370,-80269,39.01
2019-07-31,2.28,58.53,451428,438470,363927,-87501,32.47
2019-08-01,2.36,53.64,407423,399300,330575,-76848,29.53
2019-08-02,2.12,55.67,373260,370800,307453,-65807,28.25
2019-08-05,2.02,54.63,365184,354020,298283,-66901,31.96
2019-08-06,2.15,53.6,372843,370800,306182,-66661,35.95
2019-08-07,2.18,51.14,401108,395040,321035,-80073,34.37
2019-08-08,2.13,52.6,404785,396430,317306,-87479,28.64
2019-08-09,2.09,54.41,376216,368480,295806,-80410,29.66
2019-08-12,2.21,54.98,357412,352650,289572,-67840,30.59
2019-08-14,2.22,55.16,369354,361760,311938,-57416,28.23
2019-08-15,2.19,54.51,362810,354570,298329,-64481,27.69
2019-08-16,2.2,54.83,365637,358120,299091,-66546,42.4
2019-08-19,2.26,56.24,440255,436990,372061,-68194,37.42
2019-08-20,2.35,56.18,410478,407650,333671,-76807,35.12
2019-08-21,2.31,55.65,402703,411090,327123,-75580,37.59
2019-08-22,2.28,55.33,426917,419640,352294,-74623,26.63
2019-08-23,2.15,54.08,359782,359450,280923,-78859,24.16
2019-08-26,2.23,53.54,299810,293590,226279,-73531,23.0
2019-08-28,2.24,55.76,334807,332820,266078,-68729,26.9
2019-08-29,2.36,56.67,353740,353550,278684,-75056,25.99
2019-08-30,2.33,55.07,347686,344680,276950,-70736,27.0
2019-09-03,2.39,53.91,333277,330900,270911,-62366,25.95
2019-09-04,2.48,56.22,355753,349000,294376,-61377,22.26
2019-09-05,2.49,56.33,311967,307840,240520,-71447,21.94
2019-09-09,2.65,57.88,302355,292430,232370,-69985,25.0
2019-09-10,2.67,57.37,313277,311280,238977,-74300,32.31
2019-09-11,2.63,55.66,357777,350970,309329,-48448,27.48
2019-09-12,2.62,55.13,326415,319680,284110,-42305,23.67
2019-09-16,2.75,63.1,301043,300220,259734,-41309,24.72
2019-09-17,2.7,59.26,289555,288090,233864,-55691,24.44
2019-09-18,2.72,58.19,283811,281800,217181,-66630,22.89
2019-09-19,2.65,58.19,279825,277730,203569,-76256,25.12
2019-09-20,2.34,57.92,289477,282860,219372,-70105,27.4
2019-09-23,2.55,58.69,368117,367040,296240,-71877,23.87
2019-09-24,2.55,57.22,332218,332010,262111,-70107,22.08
2019-09-25,2.54,56.38,299087,297240,232798,-66289,21.9
2019-09-26,2.57,56.24,307140,302100,241708,-65432,20.25
2019-09-27,2.41,55.95,287745,286230,219493,-68252,22.56
2019-09-30,2.37,54.09,284501,280700,258433,-26068,24.77
2019-10-01,2.36,53.6,304418,301580,287468,-16950,27.23
2019-10-02,2.36,52.67,330589,325410,311471,-19118,24.6
2019-10-03,2.31,52.41,293596,293970,271520,-22076,23.28
2019-10-04,2.25,52.84,282775,277450,260883,-21892,20.25
2019-10-07,2.36,52.76,305486,305700,273243,-32243,22.59
2019-10-08,2.29,52.64,293939,293580,253563,-40376,23.94
2019-10-09,2.26,52.63,295586,291050,256540,-39046,24.03
2019-10-10,2.26,53.57,294014,295210,257458,-36556,24.75
2019-10-11,2.13,54.76,292338,287650,253284,-39054,23.2
2019-10-14,2.13,53.57,281880,279990,245304,-36576,22.68
2019-10-15,2.29,52.81,277452,277330,231641,-45811,22.54
2019-10-16,2.44,53.42,293314,286620,249984,-43330,23.88
2019-10-17,2.29,53.89,287703,288010,242962,-44741,21.59
2019-10-18,2.08,53.75,284491,287500,242433,-42058,23.0
2019-10-21,2.13,53.28,282474,281880,239591,-42883,24.3
2019-10-22,2.21,54.21,297674,291830,247227,-50447,22.14
2019-10-23,2.34,55.9,284887,282690,225639,-59248,22.38
2019-10-24,2.33,56.11,281514,278740,223653,-57861,23.08
2019-10-25,2.26,56.52,287181,281330,227582,-59599,23.75
2019-10-28,2.49,55.6,296714,292390,250551,-46163,25.13
2019-10-29,2.61,55.34,298095,293710,236470,-61625,23.93
2019-10-30,2.71,54.85,296665,293170,231294,-65371,24.21
2019-10-31,2.73,54.02,303482,304060,236752,-66730,22.36
2019-11-01,2.54,56.04,276532,274510,212241,-64291,28.75
2019-11-04,2.77,56.33,298276,294560,235331,-62945,27.88
2019-11-05,2.77,57.04,309261,302220,232290,-76971,29.18
2019-11-06,2.82,56.15,298332,291030,225304,-73028,31.71
2019-11-07,2.84,56.91,313882,310550,236950,-76932,50.11
2019-11-08,2.87,57.02,324961,315890,238628,-86333,35.67
2019-11-11,2.87,56.61,311516,306650,242407,-69109,41.19
2019-11-12,2.72,56.67,333496,326550,255659,-77837,59.89
2019-11-13,2.66,56.88,352637,346140,278895,-73742,41.2
2019-11-14,2.68,56.57,353384,349150,270365,-83019,32.16
2019-11-15,2.7,57.54,326782,317510,250062,-76720,35.36
2019-11-18,2.64,56.82,338364,336200,282216,-56148,40.56
2019-11-19,2.53,54.93,327323,324290,270696,-56627,44.2
2019-11-20,2.56,56.71,333345,327080,272809,-60536,37.98
2019-11-21,2.53,58.36,319149,313150,261704,-57445,31.68
2019-11-22,2.62,57.68,324397,315740,268438,-55959,35.0
2019-11-25,2.51,57.79,315357,312340,259387,-55970,31.75
2019-11-26,2.51,58.25,306970,305320,256460,-50510,33.65
2019-11-27,2.46,58.12,318059,314410,257337,-60722,32.0
2019-12-02,2.29,55.97,358296,354990,279527,-78769,45.03
2019-12-03,2.42,56.15,360168,358390,283621,-76547,41.31
2019-12-04,2.43,58.46,353073,352740,277349,-75724,37.43
2019-12-05,2.42,58.42,345599,342010,276099,-69500,43.14
2019-12-06,2.31,59.2,356947,350450,285471,-71476,36.84
2019-12-09,2.17,58.99,343865,338780,265320,-78545,27.0
2019-12-10,2.18,59.22,321312,318940,253874,-67438,39.9
2019-12-11,2.28,58.74,347988,346620,277586,-70402,41.33
2019-12-12,2.28,59.18,363786,360630,288241,-75545,30.55
2019-12-13,2.28,60.11,357742,354330,289508,-68234,37.5
2019-12-16,2.34,60.21,360595,354410,284616,-75979,45.29
2019-12-17,2.3,60.88,375668,369880,295065,-80603,75.17
2019-12-18,2.26,60.93,363841,367060,289732,-74109,109.55
2019-12-19,2.21,61.3,391146,390960,309854,-81292,101.16
2019-12-20,2.27,60.43,382554,381690,297484,-85070,44.67
2019-12-23,2.17,60.51,330528,330360,247481,-83047,42.3
2019-12-24,2.11,61.17,321086,306840,239803,-81283,31.5
2019-12-26,2.09,61.72,332243,327110,252108,-80135,26.53
2019-12-30,2.06,61.66,346756,340220,263526,-83230,25.75
2019-12-31,2.09,61.14,329257,322670,248508,-80749,24.0
2020-01-02,2.05,61.17,331953,325420,254387,-77566,26.63
2020-01-07,2.17,62.7,341261,340450,269625,-71636,30.62
2020-01-08,2.09,59.65,341572,342920,268827,-72745,28.78
2020-01-09,2.05,59.56,356314,356940,290854,-65460,21.18
2020-01-10,2.05,59.02,343633,339570,279214,-64419,25.0
2020-01-13,2.03,58.17,335116,330430,272177,-62939,27.43
2020-01-15,2.01,57.86,323998,316880,259661,-64337,34.95
2020-01-16,2.06,58.52,335223,333040,266798,-68425,56.71
2020-01-17,2.07,58.55,364399,363720,285019,-79380,45.5
2020-01-21,1.98,58.25,371251,370560,309308,-61943,30.67
2020-01-22,1.89,56.76,360764,355570,301889,-58875,23.79
2020-01-23,1.95,55.51,348689,345820,286840,-61849,23.76
2020-01-27,2.03,53.09,324801,322510,265272,-59529,22.03
2020-01-28,1.96,53.33,333040,327740,264680,-68360,24.93
2020-01-29,1.93,53.29,329802,332380,277966,-51836,25.69
2020-01-30,1.94,52.19,339715,338580,297874,-41841,22.12
2020-01-31,1.91,51.58,330688,331540,283956,-46732,21.81
2020-02-03,1.9,50.06,324702,315700,264857,-59845,23.26
2020-02-04,1.89,49.59,328945,326060,276135,-52810,25.15
2020-02-05,1.89,50.87,324782,322200,272826,-51956,25.29
2020-02-06,1.86,50.94,342388,338740,296089,-46299,26.89
2020-02-07,1.93,50.34,337711,332370,281674,-56037,28.91
2020-02-10,1.85,49.59,337156,335080,259493,-77663,24.09
2020-02-11,1.85,50.0,334297,331490,252840,-81457,23.68
2020-02-12,1.91,51.13,318659,318340,240450,-78209,27.16
2020-02-13,1.95,51.41,337496,332820,266302,-71194,33.93
2020-02-14,1.93,52.03,337416,338310,272914,-64502,23.83
2020-02-18,2.04,52.1,346970,340660,278705,-68265,22.86
2020-02-19,2.01,53.31,320741,318740,246594,-74147,27.42
2020-02-20,1.98,53.77,339064,334430,280275,-58789,26.3
2020-02-24,1.94,51.36,302994,298490,234080,-68914,22.65
2020-02-25,1.93,49.78,307774,302150,250040,-57734,22.11
2020-02-26,1.96,48.67,310209,309460,248963,-61246,21.36
2020-02-27,1.78,47.17,317308,309190,251751,-65557,23.79
2020-03-02,1.75,46.78,315678,315040,263976,-51702,19.25
2020-03-03,1.78,47.27,293272,291410,244001,-49271,19.7
2020-03-04,1.83,46.78,298007,292190,257198,-40809,17.78
2020-03-05,1.89,45.9,295149,286380,235149,-60000,20.89
2020-03-09,1.74,31.05,287474,277920,222100,-65374,20.02
2020-03-10,1.91,34.47,287381,285160,223998,-63383,18.25
2020-03-11,1.96,33.13,282874,280220,220471,-62403,20.58
2020-03-12,1.82,31.56,305725,299010,239089,-66636,19.28
2020-03-13,1.94,31.72,310157,301750,248054,-62103,22.18
2020-03-16,1.89,28.96,301672,301600,243699,-57973,20.06
2020-03-17,1.89,26.96,320272,317150,248227,-72045,18.29
2020-03-18,1.73,20.48,289627,284030,230886,-58741,20.62
2020-03-19,1.68,25.09,309031,305990,245406,-63625,16.7
2020-03-23,1.7,23.33,322148,316120,253192,-68956,18.0
2020-03-25,1.8,20.75,305731,300590,235703,-70028,17.25
2020-03-26,1.73,16.6,275787,281150,203929,-71858,17.0
2020-03-27,1.7,15.48,257284,254030,197988,-59296,18.25
2020-03-30,1.65,14.1,302175,296000,231023,-71152,18.59
2020-03-31,1.71,20.51,287420,285860,214516,-72904,20.32
2020-04-01,1.69,20.28,283753,284720,205031,-78722,20.42
2020-04-02,1.55,25.18,288140,290130,199335,-88805,20.95
2020-04-06,1.64,26.21,256125,252920,181577,-74548,20.48
2020-04-07,1.83,23.54,256404,253070,187870,-68534,21.84
2020-04-08,1.86,24.97,269942,274340,200051,-69891,22.41
2020-04-09,1.74,22.9,290323,291770,214956,-75367,20.75
2020-04-13,1.86,22.36,278878,278740,211806,-67072,16.0
2020-04-14,1.76,20.15,252117,255340,177688,-74429,21.52
2020-04-15,1.68,19.96,264428,261480,201555,-62873,20.9
2020-04-16,1.59,19.82,276286,270730,207824,-68462,17.44
2020-04-20,1.78,-36.98,263585,261660,198049,-65536,19.83
2020-04-21,1.92,8.91,283251,283570,211086,-72165,20.31
2020-04-22,1.9,13.64,282500,275280,209880,-72620,21.5
2020-04-23,1.86,15.06,271364,268640,203273,-68091,23.31
2020-04-27,1.68,12.17,294016,293710,216427,-77589,20.03
2020-04-28,1.8,12.4,265855,272490,195341,-70514,17.7
2020-04-29,1.73,15.04,259101,259020,189473,-69628,19.59
2020-04-30,1.63,19.23,283488,282510,211922,-71566,19.38
2020-05-01,1.69,19.72,265113,265190,205548,-59565,19.0
2020-05-04,1.78,20.47,252400,249140,196702,-55698,18.64
2020-05-05,1.93,24.56,243695,242090,195617,-48078,20.0
2020-05-06,1.9,23.88,256186,257230,197450,-58736,18.5
2020-05-07,1.84,23.68,250854,245160,192001,-58853,17.69
2020-05-11,1.7,24.02,261823,261580,191846,-69977,17.5
2020-05-13,1.56,25.37,252687,250520,185950,-66737,14.92
2020-05-14,1.6,27.4,248699,249740,180334,-68365,15.73
2020-05-15,1.66,29.44,257672,255040,191215,-66457,17.58
2020-05-18,1.77,31.83,260200,259150,198054,-62146,17.69
2020-05-19,1.85,32.3,245597,243370,184511,-61086,18.27
2020-05-20,1.83,33.56,246678,241570,191126,-55552,16.75
2020-05-21,1.75,34.3,254957,246660,191468,-63489,17.63
2020-05-22,1.7,33.49,265855,254990,208262,-57593,18.92
2020-05-26,1.79,34.7,280208,271110,226044,-54164,23.08
2020-05-27,1.78,32.8,311653,311710,255187,-56466,21.04
2020-05-28,1.79,33.67,326991,316760,257547,-69444,22.11
2020-05-29,1.7,35.57,335760,331720,277837,-57923,17.0
2020-06-01,1.59,35.49,254654,252270,188600,-66054,18.25
2020-06-02,1.58,36.88,267646,263530,209824,-57822,22.41
2020-06-03,1.84,37.33,292057,289950,237601,-54456,23.77
2020-06-04,1.68,37.42,320548,318060,257541,-63007,26.33
2020-06-08,1.68,38.17,283684,277020,211829,-71855,20.5
2020-06-09,1.68,38.98,307666,300910,246728,-60938,22.44
2020-06-10,1.72,39.54,319681,310240,258093,-61588,23.5
2020-06-11,1.77,36.43,332492,330320,266259,-66233,21.24
2020-06-15,1.64,37.07,277908,275100,219136,-58772,19.0
2020-06-16,1.43,38.26,290258,279110,227611,-62647,20.02
2020-06-17,1.55,37.91,304588,298210,239278,-65310,21.17
2020-06-18,1.51,38.79,350994,346580,284024,-66970,23.88
2020-06-19,1.49,39.72,381988,380950,310704,-71284,27.25
2020-06-22,1.64,40.6,396936,392580,333708,-63228,28.74
2020-06-23,1.61,40.4,405113,397250,336566,-68547,25.43
2020-06-24,1.64,37.91,402539,395240,341482,-61057,22.0
2020-06-25,1.53,38.66,365558,355910,309345,-56213,22.41
2020-06-26,1.42,38.53,362147,359330,302811,-59336,23.83
2020-06-29,1.67,39.67,346850,348420,293367,-53483,21.0
2020-06-30,1.76,39.27,331357,328490,274995,-56362,22.88
2020-07-01,1.69,39.88,334834,333610,283290,-51544,24.2
2020-07-06,1.71,40.51,363240,360080,324149,-39091,23.09
2020-07-07,1.76,40.59,340439,338620,306817,-33622,24.9
2020-07-08,1.78,40.91,382646,379490,335255,-47391,28.0
2020-07-09,1.88,39.64,425194,422020,376814,-48380,25.06
2020-07-13,1.75,40.06,411015,415450,342106,-68909,22.0
2020-07-14,1.74,40.3,379144,373340,313813,-65331,21.5
2020-07-15,1.76,41.2,344659,340130,298558,-46101,20.36
2020-07-16,1.79,40.74,330769,324520,278885,-51884,21.71
2020-07-17,1.79,40.55,324717,328940,276049,-48668,38.75
2020-07-20,1.71,40.83,468638,463440,394905,-73733,31.13
2020-07-21,1.66,41.76,438932,428210,375648,-63284,25.62
2020-07-22,1.69,41.88,413573,409780,350211,-63362,27.06
2020-07-23,1.75,40.99,430595,430060,360829,-69766,26.17
2020-07-24,1.77,41.23,400163,395410,340958,-59205,42.72
2020-07-27,1.85,41.46,472863,475450,396461,-76402,41.21
2020-07-28,1.83,40.89,494507,487340,412830,-81677,34.0
2020-07-29,1.77,41.13,439853,434630,373647,-66206,31.11
2020-07-30,1.81,39.85,439693,434650,369636,-70057,26.88
2020-08-03,1.95,40.83,456657,451130,376839,-79818,27.32
2020-08-04,2.07,41.67,397676,381390,319568,-78108,33.32
2020-08-05,2.23,42.25,377910,371080,302164,-75746,26.24
2020-08-06,2.26,41.93,350874,352260,272214,-78660,24.86
2020-08-10,2.18,41.94,453381,441030,377332,-76049,41.77
2020-08-11,2.19,41.53,475664,463680,396184,-79480,42.02
2020-08-12,2.05,42.6,477414,467200,392174,-85240,34.04
2020-08-13,2.19,42.26,426588,420860,345679,-80909,29.75
2020-08-17,2.32,42.89,332502,326810,272457,-60045,25.0
2020-08-18,2.45,42.89,354015,351010,282619,-71396,22.61
2020-08-19,2.43,42.91,333943,328380,260697,-73246,22.0
2020-08-20,2.35,42.62,322948,314630,253329,-69619,26.63
2020-08-21,2.39,42.32,353152,346900,282631,-70521,35.46
2020-08-24,2.57,42.44,419404,415900,341042,-78362,33.88
2020-08-25,2.54,43.17,416481,411770,339517,-76964,21.75
2020-08-26,2.52,43.21,318304,316950,254679,-63625,22.74
2020-08-27,2.52,42.88,318885,316370,266998,-51887,24.39
2020-08-31,2.3,42.61,299560,294750,250553,-49007,19.84
2020-09-01,2.22,42.76,311791,307760,261868,-49923,22.44
2020-09-02,2.15,42.76,334328,331210,273094,-61234,26.96
2020-09-03,2.32,41.39,359680,356070,293243,-66437,26.35
2020-09-04,1.8,39.69,352127,351050,284013,-68114,26.0
2020-09-08,2.35,36.87,357400,357930,289868,-67532,31.86
2020-09-09,2.21,38.05,366671,358050,302960,-63711,35.54
2020-09-10,2.13,37.25,389613,383690,317795,-71818,26.0
2020-09-14,2.18,37.23,304987,304880,262531,-42456,21.47
2020-09-15,2.19,38.29,276486,275570,245227,-31259,20.25
2020-09-16,2.06,40.17,282326,281670,243530,-38796,22.0
2020-09-17,1.65,40.99,300222,297020,268208,-32014,18.13
2020-09-18,1.56,41.09,282700,278710,253370,-29330,20.0
2020-09-21,1.33,39.26,274842,269990,252339,-22503,19.7
2020-09-22,1.49,39.55,281545,279530,255789,-25756,20.0
2020-09-23,1.74,39.92,283274,280020,257225,-26049,23.4
2020-09-24,1.93,40.11,294469,290870,270824,-23645,24.88
2020-09-25,1.9,40.06,293883,296500,273215,-20668,24.0
2020-09-28,1.83,40.47,339548,336450,278796,-60752,26.47
2020-09-29,1.74,39.03,335572,329710,276248,-59324,23.48
2020-09-30,1.66,40.05,318545,316290,252000,-66545,19.5
2020-10-01,1.6,38.51,290994,287710,227465,-63529,17.79
2020-10-02,1.41,36.9,291599,288780,221086,-70513,22.38
2020-10-05,1.92,39.12,285572,281670,208752,-76820,23.38
2020-10-06,1.86,40.52,286232,282370,212159,-74073,24.4
2020-10-07,2.01,39.82,288571,283740,222522,-66049,22.13
2020-10-08,1.49,41.04,276557,269600,217270,-59287,19.19
2020-10-12,2.31,39.22,283580,280360,217576,-66004,27.0
2020-10-13,2.14,40.03,303438,295200,235795,-67643,27.58
2020-10-14,2.02,40.86,282783,276360,212579,-70204,23.91
2020-10-15,2.23,40.84,280579,277900,212569,-68010,26.75
2020-10-19,2.3,40.69,284475,283010,232828,-51647,29.99
2020-10-20,2.57,41.37,292709,290910,242025,-50684,28.95
2020-10-21,2.95,39.88,295761,293050,244600,-51161,28.88
2020-10-22,2.99,40.46,291265,289110,229405,-61860,25.91
2020-10-26,3.14,38.39,301033,299090,244277,-56756,36.59
2020-10-27,3.07,39.34,291337,288630,234626,-56711,34.21
2020-10-28,3.14,37.27,305210,300660,254405,-50805,48.0
2020-10-29,3.06,35.94,311554,304970,253357,-58197,57.08
2020-10-30,3.03,35.64,326363,321850,253835,-72528,43.12
2020-11-02,3.03,36.6,315091,309640,250517,-64574,42.68
2020-11-03,2.88,37.44,315337,310680,254414,-60923,32.75
2020-11-04,2.63,38.97,306971,298400,251964,-55007,23.32
2020-11-05,2.69,38.56,291180,285880,229809,-61371,19.21
2020-11-06,2.67,36.97,281574,276990,220954,-60620,19.0
2020-11-09,2.63,40.05,284011,276550,227813,-56198,16.85
2020-11-10,2.74,41.18,286422,281230,222837,-63585,20.25
2020-11-11,2.75,41.23,301299,290400,226018,-75281,25.98
2020-11-12,2.81,40.9,301108,297720,230718,-70390,30.13
2020-11-16,2.62,41.14,299531,297330,236193,-63338,42.33
2020-11-17,2.55,41.24,315673,309690,249970,-65703,43.35
2020-11-18,2.37,41.64,333503,324280,263150,-70353,30.85
2020-11-19,2.19,41.57,334653,332720,267622,-67031,25.19
2020-11-23,2.23,42.91,321545,313540,248256,-73289,34.91
2020-11-24,2.47,44.71,324259,316880,247458,-76801,29.96
2020-11-25,2.47,45.58,326757,325590,255115,-71642,22.5
2020-11-30,2.89,45.2,321513,317620,244816,-76697,26.7
2020-12-01,2.89,44.54,301909,301440,227022,-74887,30.65
2020-12-02,2.75,45.23,321611,318530,245751,-75860,26.82
2020-12-03,2.46,45.65,316831,314130,248395,-68436,25.91
2020-12-04,2.48,46.23,313550,314930,240052,-73498,38.55
2020-12-07,2.39,45.72,348110,340380,266907,-81203,35.86
2020-12-08,2.36,45.64,359894,350920,292794,-67100,34.13
2020-12-09,2.45,45.48,358536,354570,298810,-59726,28.5
2020-12-10,2.45,46.76,336325,332630,277683,-58642,27.56
2020-12-11,2.54,46.59,328995,323700,260221,-68774,37.56
2020-12-14,2.69,47.02,345049,342290,266032,-79017,48.03
2020-12-15,2.63,47.58,351735,343890,274566,-77169,66.85
2020-12-16,2.73,47.86,377480,372150,309184,-68296,81.5
2020-12-17,2.7,48.34,379702,377520,313004,-66698,100.78
2020-12-18,2.73,49.04,378568,367590,317102,-61466,49.29
2020-12-21,2.68,47.79,355818,353000,278860,-76958,43.46
2020-12-22,2.76,47.02,345276,340700,265392,-79884,40.58
2020-12-23,2.76,47.94,344307,343190,270973,-73334,29.5
2020-12-28,2.39,47.5,341374,340850,265567,-75807,42.11
2020-12-29,2.4,47.85,337930,337020,253265,-84665,38.72
2020-12-30,2.36,48.24,351167,351190,272854,-78313,28.5
2021-01-04,2.6,47.47,340809,342850,268231,-72578,32.83
2021-01-05,2.77,49.78,343513,343880,267819,-75694,33.5
2021-01-06,2.76,50.45,340610,336700,270960,-69650,29.54
2021-01-07,2.81,50.63,340700,334710,275567,-65133,34.13
2021-01-08,2.77,52.14,342004,336440,290193,-51811,40.7
2021-01-11,2.71,52.15,358334,359090,294051,-64283,41.52
2021-01-12,2.89,53.08,346955,343350,277401,-69554,43.72
2021-01-13,2.82,52.81,335534,335330,272124,-63410,45.21
2021-01-14,2.82,53.47,339765,336350,266138,-73627,36.34
2021-01-15,2.86,52.25,327996,327090,256990,-71006,53.17
2021-01-19,2.65,52.87,337557,334140,270579,-66978,40.25
2021-01-20,2.57,53.16,342056,345950,283819,-58237,39.75
2021-01-21,2.49,53.0,361346,361870,308464,-52882,33.7
2021-01-22,2.45,52.28,342612,333360,292675,-49937,51.71
2021-01-25,2.63,52.78,356867,352620,294220,-62647,49.9
2021-01-26,2.73,52.61,359585,353870,298091,-61494,46.48
2021-01-27,2.77,52.81,357058,350330,298257,-58801,76.62
2021-01-28,2.76,52.26,365046,356880,304644,-60402,98.58
2021-01-29,2.68,52.16,396136,388670,351641,-44495,54.0
2021-02-01,2.88,53.55,377922,378510,317668,-60254,68.0
2021-02-02,3.24,54.77,359600,358900,292089,-67511,94.17
2021-02-03,3.01,55.67,353153,350510,278709,-74444,104.36
2021-02-04,2.99,56.19,348470,343690,274951,-73519,80.53
2021-02-08,3.4,57.95,367666,362870,299467,-68199,107.25
2021-02-09,3.35,58.34,378237,373960,307008,-71229,94.31
2021-02-10,3.76,58.69,370549,369940,314552,-55997,109.19
2021-02-11,6.5,58.22,367759,365560,301438,-66321,106.16
2021-02-12,6.12,59.5,371089,371490,320128,-50961,75.91
2021-02-16,11.32,60.07,345787,340360,286979,-58808,103.36
2021-02-17,23.86,61.09,345735,343220,301821,-43914,105.85
2021-02-18,8.56,60.4,365741,360520,329511,-36230,86.74
2021-02-19,4.96,59.12,360926,360050,320017,-40909,60.45
2021-02-22,3.16,61.67,359109,359420,309009,-50100,51.77
2021-02-23,2.94,61.66,334239,328950,282202,-52037,36.3
2021-02-24,2.8,63.21,315713,310460,257166,-58547,31.05
2021-02-25,2.72,63.43,310371,304470,259299,-51072,31.2
2021-02-26,2.66,61.55,317488,315440,262362,-55126,33.0
2021-03-01,2.7,60.54,335489,327690,273101,-51977,60.89
2021-03-02,2.87,59.7,354424,344800,314389,-40035,45.77
2021-03-03,2.86,61.33,334151,327240,294442,-39709,67.37
2021-03-04,2.79,63.81,332599,324990,289116,-43483,68.17
2021-03-05,2.72,66.08,335693,332980,291904,-43789,47.7
2021-03-08,2.67,65.03,321804,318890,277941,-43863,32.92
2021-03-09,2.62,64.02,307333,300090,262637,-44696,31.08
2021-03-10,2.62,64.45,299538,291380,245741,-53797,28.19
2021-03-11,2.7,66.02,296337,291970,235440,-60897,26.83
2021-03-15,2.58,65.36,344328,332100,290765,-53563,52.76
2021-03-16,2.5,64.82,337993,332010,283399,-54594,36.42
2021-03-17,2.6,64.55,313974,309860,259564,-54410,33.58
2021-03-18,2.45,59.95,325831,315520,265558,-60273,34.5
2021-03-22,2.55,61.48,277225,276080,234962,-42263,25.32
2021-03-23,2.56,57.75,278195,274190,236606,-41589,27.76
2021-03-24,2.56,61.12,287183,282620,245850,-41333,24.45
2021-03-25,2.52,58.47,280308,279310,233194,-47114,25.66
2021-03-29,2.58,61.49,283049,276780,238348,-44701,24.53
2021-03-30,2.55,60.55,277952,273760,233834,-44118,24.66
2021-03-31,2.52,59.19,285281,281660,242495,-42786,29.88
2021-04-01,2.52,61.41,296219,289790,255469,-40750,30.05
2021-04-05,2.43,58.73,279462,273150,235672,-43790,27.13
2021-04-06,2.44,59.34,268825,265550,222707,-46118,24.8
2021-04-07,2.43,59.77,267126,266540,222687,-44439,24.25
2021-04-08,2.47,59.61,260972,260470,214748,-46224,23.11
2021-04-09,2.48,59.29,256849,254520,215599,-41250,27.75
2021-04-12,2.5,59.7,287700,282730,243312,-44388,25.75
2021-04-13,2.57,60.2,273699,270830,226710,-46989,26.75
2021-04-14,2.65,63.15,266217,263610,228317,-37900,29.57
2021-04-15,2.62,63.42,293257,289260,256014,-37243,33.35
2021-04-16,2.63,63.16,310418,304590,267389,-43029,31.0
2021-04-19,2.75,63.33,263728,255820,218370,-45358,27.5
2021-04-20,2.76,62.61,264535,261300,226061,-38474,30.0
2021-04-21,2.72,61.34,273974,267190,236178,-37796,37.8
2021-04-22,2.77,61.45,290318,285090,248595,-41723,27.03
2021-04-26,2.73,62.02,263351,254560,225767,-37584,28.38
2021-04-27,2.91,63.03,269633,268510,242056,-27577,30.01
2021-04-28,2.98,63.81,271590,271720,242524,-29066,30.57
2021-04-29,2.91,65.0,288599,281160,270255,-18344,27.08
2021-04-30,2.86,63.5,270766,266400,231348,-39418,27.0
2021-05-03,2.96,64.46,266278,265400,236615,-29663,34.0
2021-05-04,3.0,65.72,277814,279700,252146,-25668,29.5
2021-05-05,2.99,65.63,286107,282870,254046,-32061,27.54
2021-05-06,2.9,64.73,258809,258010,223520,-35289,27.15
2021-05-10,2.93,64.92,268155,263970,234218,-33937,28.08
2021-05-11,2.91,65.31,257454,253430,221244,-36210,27.21
2021-05-12,2.91,65.96,262008,256690,232383,-29625,25.63
2021-05-13,2.95,63.82,260795,261050,231682,-29113,25.5
2021-05-14,2.95,65.32,262132,256740,234852,-27280,27.0
2021-05-17,2.99,66.24,269936,264240,229673,-40263,31.81
2021-05-18,2.96,65.49,280103,273890,242333,-37770,30.75
2021-05-19,2.88,63.28,283678,285000,248226,-35452,28.63
2021-05-20,2.86,61.95,279314,276560,242006,-37308,28.0
2021-05-21,2.84,63.61,286678,278510,244475,-42203,28.0
2021-05-24,2.78,66.13,277435,274860,238676,-38759,26.1
2021-05-25,2.87,66.27,279831,275830,236818,-43013,32.84
2021-05-26,2.91,66.41,335403,335980,294375,-41028,27.88
2021-05-27,2.85,66.87,323199,319700,291911,-31288,24.71
2021-06-01,3.02,67.8,274456,274440,227337,-47119,27.84
2021-06-02,3.09,68.79,289377,286740,245267,-44110,27.88
2021-06-03,3.01,68.81,306868,301060,255065,-51803,28.25
2021-06-04,3.01,69.57,325040,321370,280529,-44511,47.36
2021-06-07,2.98,69.21,432143,428200,377556,-54587,55.86
2021-06-08,3.11,70.11,445066,443300,383133,-61933,44.26
2021-06-09,3.13,69.9,431565,428230,369462,-62103,37.57
2021-06-10,3.13,70.34,341827,337250,301911,-39916,32.44
2021-06-14,3.36,70.94,317155,302610,261939,-55216,32.71
2021-06-15,3.31,72.06,322925,317740,264260,-58665,31.25
2021-06-16,3.25,72.03,301180,295620,245617,-55563,29.72
2021-06-17,3.24,71.06,296411,288420,237641,-58770,32.94
2021-06-18,3.23,71.64,311071,305360,258701,-52370,53.46
2021-06-21,3.15,73.64,404758,402000,349067,-55691,36.07
2021-06-22,3.21,73.15,370816,365900,308786,-62030,30.22
2021-06-23,3.36,73.11,296744,292070,240845,-55899,29.75
2021-06-24,3.3,73.31,296827,295340,237189,-59638,34.92
2021-06-28,3.62,72.98,473774,459560,412915,-60859,81.29
2021-06-29,3.75,73.14,502879,490900,429001,-73878,126.46
2021-06-30,3.79,73.52,493328,491160,418130,-75198,58.6
2021-07-01,3.76,75.33,413664,410790,337568,-76096,35.0
2021-07-02,3.67,75.37,330738,333200,277174,-53564,61.04
2021-07-06,3.68,73.62,377495,379740,322118,-55377,52.33
2021-07-07,3.66,72.22,410113,403200,351583,-58530,38.57
2021-07-08,3.56,72.98,347218,348040,299332,-47886,38.73
2021-07-12,3.7,74.21,346517,342390,303580,-42937,38.76
2021-07-13,3.78,75.24,334358,331210,292809,-41549,42.32
2021-07-14,3.8,73.06,366004,363850,303366,-62638,53.16
2021-07-15,3.68,71.67,413893,406560,356014,-57879,60.29
2021-07-19,3.75,66.45,362601,358130,309459,-53142,56.25
2021-07-20,3.82,67.32,391471,387060,333826,-57645,43.33
2021-07-21,3.94,70.26,382831,375050,319446,-63385,36.18
2021-07-22,4.02,72.15,342620,339350,285085,-57535,35.17
2021-07-26,4.09,72.15,394639,391870,343228,-51411,52.75
2021-07-27,4.15,71.68,397529,393620,340974,-56555,38.63
2021-07-28,4.1,72.37,350111,346120,309297,-40814,36.73
2021-07-29,4.03,73.62,340795,340090,298121,-42674,35.94
2021-08-02,4.02,71.31,330808,329900,272476,-58332,37.55
2021-08-03,4.06,70.64,323545,320270,270042,-53503,39.08
2021-08-04,4.2,68.19,326838,326100,279809,-47029,42.27
2021-08-05,4.27,69.1,332768,334980,278888,-53880,51.03
2021-08-06,4.21,68.26,366169,364180,312252,-53917,50.97
2021-08-09,4.24,66.56,370396,377690,318246,-52150,52.92
2021-08-11,4.07,69.3,446916,440190,377857,-69059,102.21
2021-08-12,4.1,69.12,481968,486440,410174,-71794,91.8
2021-08-16,3.93,67.44,346328,339330,296163,-50165,42.77
2021-08-17,3.92,66.5,369715,364960,315034,-54681,49.94
2021-08-18,3.86,65.36,403435,403260,343411,-60024,56.69
2021-08-19,3.83,63.69,418537,412120,361415,-57122,64.78
2021-08-23,3.93,65.65,385732,382810,329540,-56192,69.5
2021-08-24,3.95,67.5,424286,417460,358836,-65450,83.5
2021-08-25,4.03,68.54,449819,443060,379470,-70349,110.75
2021-08-26,4.07,67.42,475262,466990,410234,-65028,76.67
2021-08-30,4.25,69.28,394818,396150,336388,-58430,54.65
2021-08-31,4.33,68.43,387675,389800,330849,-56826,43.55
2021-09-01,4.45,68.63,346980,342740,293552,-53428,38.34
2021-09-02,4.65,70.07,309421,303590,249510,-59911,38.79
2021-09-07,4.71,68.49,317851,315190,266194,-51657,51.75
2021-09-08,4.66,69.36,348876,339870,300788,-48088,48.77
2021-09-09,4.97,68.26,363519,364000,302341,-61178,44.66
2021-09-10,5.13,69.82,315502,315340,253717,-61785,59.37
2021-09-13,5.21,70.54,346442,339450,317972,-28470,55.0
2021-09-14,5.39,70.53,323734,317420,301365,-22369,72.61
2021-09-15,5.66,72.59,382255,374840,348034,-34221,65.33
2021-09-16,5.52,72.69,347167,345150,321533,-25634,63.2
2021-09-20,5.25,70.41,293716,292690,277956,-15760,54.67
2021-09-21,4.96,70.51,303519,295270,280234,-23285,57.18
2021-09-22,4.92,72.37,345192,337590,324704,-20488,68.71
2021-09-23,4.94,73.43,363872,358730,346794,-17078,58.44
2021-09-27,5.53,75.54,293315,291520,269371,-23944,53.0
2021-09-28,5.94,75.44,311298,309440,290295,-21003,52.86
2021-09-29,5.73,75.06,283277,277040,266670,-16607,49.25
2021-09-30,5.58,75.22,283825,275370,261870,-21955,53.59
2021-10-01,5.61,76.01,274980,269610,254295,-20685,55.4
2021-10-04,5.8,77.68,304443,302020,252116,-52327,65.5
2021-10-05,6.37,79.17,296470,292330,245099,-51371,65.68
2021-10-06,6.0,77.66,288327,284810,232552,-55775,67.63
2021-10-07,5.71,78.46,291415,286160,235843,-55572,69.0
2021-10-11,5.46,80.64,289594,283570,228078,-61516,67.78
2021-10-12,5.34,80.75,292556,286610,235773,-56783,64.2
2021-10-13,5.56,80.67,296460,291060,241124,-55336,72.16
2021-10-14,5.92,81.43,302672,300030,238638,-64034,88.5
2021-10-18,5.01,82.62,273491,271450,215962,-57529,67.75
2021-10-19,4.81,83.19,277816,272680,211133,-66683,59.89
2021-10-20,4.87,84.4,280032,276120,219874,-60158,60.42
2021-10-21,4.94,82.64,286273,282750,226347,-59926,59.0
2021-10-25,5.72,84.64,299771,295700,245910,-53861,69.25
2021-10-26,5.59,85.64,307367,300860,249407,-57960,68.25
2021-10-27,5.91,82.66,290642,284670,239856,-50786,65.4
2021-10-28,5.68,82.78,286855,283800,241452,-45403,66.95
2021-10-29,5.49,83.5,293707,289100,244868,-48839,63.18
2021-11-01,5.22,84.08,281109,272600,230826,-50283,62.65
2021-11-02,5.33,83.91,292772,290880,251482,-41290,67.93
2021-11-03,5.59,80.82,294807,290430,250920,-43887,71.5
2021-11-04,5.73,78.88,304002,297330,265202,-38800,67.5
2021-11-08,5.53,81.96,291426,288080,269188,-22238,53.2
2021-11-09,5.08,84.12,292218,284590,269954,-22264,50.5
2021-11-10,4.56,81.23,290784,285220,259430,-31354,51.83
2021-11-11,4.81,81.47,288174,284690,250247,-37927,48.47
2021-11-15,4.77,80.85,304036,299480,277899,-26137,54.2
2021-11-16,5.11,80.76,307764,301610,283574,-24190,0.0
2021-11-17,4.82,78.32,316916,309840,285654,-31262,48.06
2021-11-18,4.95,78.92,296175,290880,260146,-36029,50.33
2021-11-22,4.83,76.74,309034,307270,259188,-49846,90.27
2021-11-23,4.95,78.32,323627,318250,278412,-45215,69.41
2021-11-24,4.93,78.32,328060,322230,282725,-45335,72.5
2021-11-29,4.9,69.88,338869,336270,300123,-38746,89.53
2021-11-30,4.52,66.14,343224,340100,298901,-44323,76.95
2021-12-01,4.31,65.44,334200,329300,296092,-38108,64.01
2021-12-02,4.08,66.6,330935,326630,290802,-40133,76.11
2021-12-03,3.79,66.39,321616,316210,266741,-54875,60.67
2021-12-06,3.66,69.62,325695,323490,258908,-66787,73.86
2021-12-07,3.6,71.94,325017,322320,252961,-72056,110.94
2021-12-08,3.79,72.43,353596,346720,274225,-79371,89.25
2021-12-09,3.67,70.87,355009,350110,276664,-78345,51.25
2021-12-10,3.65,71.71,352519,344600,289385,-63134,51.67
2021-12-13,4.05,71.19,326853,323170,259737,-67116,47.71
2021-12-14,3.71,70.57,321498,322000,270449,-51049,41.08
2021-12-15,3.79,70.89,335063,334660,276727,-58336,35.0
2021-12-17,3.71,70.93,303847,297500,243162,-60685,228.78
2021-12-20,3.91,68.69,359329,350050,275009,-84320,90.0
2021-12-21,3.96,71.1,349658,347240,269636,-80022,89.9
2021-12-22,3.95,72.82,353171,347230,263565,-89606,130.0
2021-12-23,3.56,73.89,351153,348350,259236,-91917,88.29
2021-12-28,3.32,76.01,333372,333630,255141,-78231,50.54
2021-12-29,3.4,76.58,334348,332170,256410,-77938,44.33
2021-12-30,3.82,76.83,324901,324730,253794,-71107,39.65
2021-12-31,3.82,75.33,306786,301410,232742,-74044,95.0
2022-01-03,3.74,75.99,360348,360140,288238,-72110,86.2
2022-01-04,3.73,77.0,359700,358430,294641,-65059,80.1
2022-01-05,3.78,77.83,353356,349760,300489,-52867,100.77
2022-01-06,3.94,79.47,337612,330450,273880,-63732,166.63
2022-01-10,4.16,78.11,360315,356740,276328,-83987,178.85
2022-01-11,4.16,81.17,396872,398010,328342,-68530,154.74
2022-01-12,4.62,82.51,383650,383160,303493,-80157,156.33
2022-01-13,4.78,81.97,355442,350260,264972,-90470,185.33
2022-01-18,4.55,85.42,363593,363330,278611,-84982,151.54
2022-01-19,4.89,86.84,366746,362310,282532,-84214,175.44
2022-01-20,4.45,86.29,361534,356620,285794,-75740,193.78
2022-01-24,4.2,84.48,359402,359050,293926,-65476,172.54
2022-01-25,4.24,86.61,359407,354960,272888,-86519,194.36
2022-01-26,4.43,88.33,370501,372290,300146,-70355,176.85
2022-01-27,4.43,87.61,386405,386990,317113,-69292,168.95
2022-01-31,5.56,89.16,387854,383620,321291,-66563,176.17
2022-02-01,5.45,88.22,385034,378930,312976,-72058,153.89
2022-02-02,6.7,88.16,354366,350950,271149,-83217,152.22
2022-02-03,5.84,90.17,347510,341360,256361,-91149,177.42
2022-02-04,5.34,92.27,361822,353990,278170,-83652,172.0
2022-02-07,4.44,91.25,368028,370860,300745,-67283,129.77
2022-02-09,4.13,89.57,332741,328730,282512,-50229,80.11
2022-02-10,4.03,89.83,332234,329600,277323,-54911,48.61
2022-02-11,4.04,93.1,314720,309050,236187,-78533,109.15
2022-02-14,4.05,95.52,373658,369040,322623,-51035,185.24
2022-02-15,4.31,92.07,384041,377430,316606,-67435,73.24
2022-02-16,4.39,93.83,363814,359110,285763,-78051,46.1
2022-02-17,4.57,91.78,322595,313600,250465,-72130,68.98
2022-02-18,4.61,91.26,307223,304770,243867,-63356,68.2
2022-02-22,4.48,92.11,329999,324660,261657,-68342,46.74
2022-02-23,4.59,92.14,298894,299840,237439,-61455,110.68
2022-02-24,4.78,92.77,342758,342690,265554,-77204,172.31
2022-02-28,4.46,96.13,348485,349640,267823,-80662,98.44
2022-03-01,4.36,103.66,359068,361950,289773,-69295,56.56
2022-03-02,4.65,110.74,322897,317390,263493,-59404,151.93
2022-03-03,4.63,107.69,331250,328100,279392,-51858,141.09
2022-03-07,4.93,119.26,303902,299630,258919,-44983,50.07
2022-03-08,4.61,123.64,297854,292500,264244,-33610,58.42
2022-03-09,4.55,108.81,340462,339190,310099,-30363,47.68
2022-03-10,4.65,105.93,314871,311120,281222,-33649,45.93
2022-03-11,4.79,109.31,299567,297970,270835,-28732,53.63
2022-03-14,4.59,103.22,308032,308620,269981,-38051,46.73
2022-03-15,4.46,96.42,292485,290740,264529,-27956,42.75
2022-03-16,4.68,94.85,283269,283270,256931,-26338,45.23
2022-03-17,4.8,102.97,299356,297270,270592,-28764,41.94
2022-03-21,4.77,112.14,281924,270960,255024,-26900,47.02
2022-03-22,5.0,111.03,283952,277140,260396,-23556,51.63
2022-04-06,6.29,96.39,297884,297470,253650,-44234,73.35
2022-04-07,6.05,96.05,300406,295590,256672,-43734,65.02
2022-04-11,6.35,94.22,267811,265880,226734,-41077,63.67
2022-04-12,6.59,100.52,275278,272560,238250,-37028,68.34
2022-04-13,6.68,104.26,268671,262880,231168,-37503,69.88
2022-04-14,6.94,106.84,273643,268980,242956,-30687,64.84
2022-04-18,7.48,108.24,265554,260890,236015,-29539,79.59
2022-04-19,7.44,102.54,285126,281510,254921,-30205,73.49
2022-04-20,7.12,102.56,269205,266630,235164,-34041,66.26
2022-04-21,6.88,103.89,272780,267240,238897,-33883,63.59
2022-04-22,6.59,102.86,255342,253310,218316,-37026,67.0
2022-04-25,6.42,99.6,263419,262250,233559,-29860,78.21
2022-04-26,6.89,102.62,287042,283810,245309,-41733,69.83
2022-04-27,6.91,101.96,272374,267760,234981,-37393,91.76
2022-04-28,6.97,105.47,273917,269990,242271,-31646,69.5
2022-04-29,6.84,104.59,266472,260440,234455,-32017,74.5
2022-05-02,7.3,105.18,279726,274170,235897,-43829,79.69
2022-05-03,7.84,102.53,281098,275570,231316,-49782,95.29
2022-05-04,8.3,107.84,293203,289520,243672,-49531,86.04
2022-05-05,8.42,108.17,258311,254200,211497,-46814,82.11
2022-05-09,8.06,103.08,257321,251650,212703,-44618,70.9
2022-05-10,6.78,99.74,255652,251040,218711,-36941,67.86
2022-05-11,7.53,105.5,260466,258150,227993,-32473,74.6
2022-05-12,7.25,106.15,268994,266630,230964,-38030,71.33
2022-05-16,8.07,114.07,308774,306600,271604,-37170,74.25
2022-05-17,8.26,112.31,278168,273580,235292,-42876,70.5
2022-05-18,8.53,109.67,259839,254140,223309,-36530,81.33
2022-05-19,8.21,112.21,287458,284160,249770,-37688,77.43
2022-05-20,7.97,112.63,269846,273260,233519,-36327,85.0
2022-05-23,8.16,110.32,293479,292830,259266,-34213,70.02
2022-05-24,8.87,112.55,266830,263210,240869,-25961,74.62
2022-05-25,9.44,112.88,267613,260740,235196,-32417,81.18
2022-05-26,9.19,116.19,271429,265380,241728,-29701,87.5
2022-05-31,8.46,114.38,338067,331770,300678,-37389,82.13
2022-06-01,8.47,115.26,295178,293550,251938,-43240,79.86
2022-06-02,8.9,116.88,294570,295800,262381,-32189,81.25
2022-06-03,8.34,118.97,294029,288740,261092,-32937,79.5
2022-06-06,9.08,118.41,295860,288620,267666,-28194,76.52
2022-06-07,9.28,119.55,304777,297310,265847,-38930,86.71
2022-06-08,9.43,121.94,328185,325810,293052,-35133,85.48
2022-06-09,8.16,121.52,332424,334320,296693,-35731,70.53
2022-06-10,8.78,120.73,302466,297750,265382,-37084,80.09
2022-06-13,9.0,120.92,345065,337240,298983,-46082,85.71
2022-06-14,7.68,118.92,329289,327120,295530,-33759,75.66
2022-06-15,7.72,115.32,323282,322500,284965,-38317,74.0
2022-06-16,7.88,117.56,311231,313220,269798,-41433,89.82
2022-06-21,6.6,110.49,291136,288330,257859,-33277,63.44
2022-06-23,6.54,105.75,306793,301030,267594,-39199,62.5
2022-06-24,5.8,109.07,318525,311790,279830,-38695,64.71
2022-06-28,6.66,113.66,325834,317070,286116,-39718,67.15
2022-06-29,6.69,111.65,337048,333400,301744,-35304,83.81
2022-06-30,6.54,107.76,339432,335080,301311,-38121,95.49
2022-07-05,5.72,101.55,340583,338690,310296,-30287,70.22
2022-07-06,5.65,100.31,363214,362130,333902,-29312,57.75
2022-07-07,5.83,104.62,339080,337590,313482,-25598,60.22
2022-07-11,6.82,106.09,350744,344890,313244,-37500,80.12
2022-07-12,6.81,97.69,387479,381340,349925,-37554,81.32
2022-07-13,6.68,98.44,402365,399680,364804,-37561,67.7
2022-07-14,6.9,97.79,394430,383390,355723,-38707,65.64
2022-07-15,6.6,99.59,358642,357950,325372,-33270,82.63
2022-07-18,7.65,104.48,407912,410900,365230,-42682,130.52
2022-07-19,7.35,106.12,436212,437560,381081,-55131,180.58
2022-07-20,7.58,104.45,469446,462140,399107,-70339,299.67
2022-07-21,7.99,98.44,481099,475370,415125,-65974,207.74
2022-07-22,8.25,97.71,459670,457910,388140,-71530,203.5
2022-07-25,8.52,99.83,473421,455150,409219,-64202,92.64
2022-07-26,9.46,97.74,384323,384930,331805,-52518,102.52
2022-07-27,8.65,100.03,364223,368160,312656,-51567,110.5
2022-07-28,8.75,99.11,416690,411550,358665,-58025,110.01
2022-07-29,8.33,101.31,430589,422420,361306,-69283,116.64
2022-08-01,8.2,96.59,392234,388210,325852,-66382,124.54
2022-08-02,8.01,97.14,423839,419970,364705,-59134,98.45
2022-08-03,7.81,93.25,422512,415490,375688,-46824,183.82
2022-08-04,8.4,91.29,461511,455530,411450,-50061,172.32
2022-08-08,7.76,93.52,492704,487150,444172,-48532,196.65
2022-08-09,7.87,93.18,492041,488870,438379,-53662,106.46
2022-08-10,7.86,94.68,397300,394260,345645,-51655,98.34
2022-08-11,8.53,97.02,386761,383940,332052,-54709,86.6
2022-08-12,8.73,94.86,351007,343800,303593,-47414,86.88
2022-08-15,8.62,92.24,337208,332240,280952,-56256,82.5
2022-08-16,9.28,89.23,338343,332460,283063,-55280,79.06
2022-08-17,9.51,90.85,336058,329140,274576,-61482,82.56
2022-08-18,9.42,93.2,336867,332440,278565,-58302,102.5
2022-08-22,9.85,93.42,375383,370170,323817,-51566,103.61
2022-08-23,9.75,96.46,377702,380040,325928,-51774,120.48
2022-08-24,9.27,95.52,389769,387830,338087,-51682,125.62
2022-08-25,9.47,93.33,403359,395960,344556,-58803,100.16
2022-08-26,9.48,93.63,394005,392840,345364,-48641,110.86
2022-09-01,9.38,87.09,328618,327330,277581,-51037,76.1
2022-09-06,8.52,87.35,328234,329580,277448,-50786,79.39
2022-09-08,8.27,84.04,301650,305400,251486,-50164,74.0
2022-09-12,8.2,88.18,349079,347050,316738,-32341,71.93
2022-09-13,8.49,87.84,361835,360770,328076,-33759,77.5
2022-09-14,8.7,88.88,322341,321330,290125,-32216,71.03
2022-09-15,8.6,85.72,286768,285170,256999,-29769,71.93
2022-09-19,7.96,86.15,328602,324810,330183,1581,83.21
2022-09-20,8.01,84.69,313161,309360,315752,2591,75.0
2022-09-21,7.99,83.38,296235,300160,297171,936,71.56
2022-09-26,6.75,77.17,282887,286530,279240,-3647,51.5
2022-09-28,6.59,82.61,276091,276180,273858,-2233,52.33
2022-09-29,6.57,81.78,272254,270590,271133,-1121,47.0
2022-10-03,5.64,84.05,283754,277660,244749,-39005,57.33
2022-10-04,5.4,86.87,293391,289160,252695,-40696,63.68
2022-10-05,5.84,88.22,296482,292390,251053,-45429,63.06
2022-10-06,6.91,88.9,280453,279930,230441,-50012,63.15
2022-10-11,6.2,89.75,276416,270520,229911,-46505,67.56
2022-10-12,6.6,87.83,276343,274120,229000,-47343,71.13
2022-10-13,6.25,89.59,296048,295500,253068,-42980,61.0
2022-10-14,6.1,86.1,287810,287030,245538,-42272,63.56
2022-10-17,6.08,86.0,291689,286330,255229,-36460,62.79
2022-10-18,6.16,83.29,285909,284300,238268,-47641,61.17
2022-10-19,5.63,86.0,277831,274460,231224,-46607,52.65
2022-10-20,5.1,86.02,276589,276460,234804,-41785,46.04
2022-10-24,4.81,86.12,298856,293640,254703,-44153,54.82
2022-10-26,5.28,89.39,299996,300380,265682,-34314,49.19
2022-10-27,5.3,89.06,273072,273310,235831,-37241,48.63
2022-10-31,5.02,86.54,280400,280420,234885,-45515,57.19
2022-11-01,4.57,88.36,294711,292040,230905,-63806,46.07
2022-11-02,4.58,90.06,276342,270140,236889,-39453,45.22
2022-11-03,4.65,88.14,276393,273610,248386,-28007,39.43
2022-11-07,4.62,91.8,287584,286760,256300,-31284,43.0
2022-11-08,4.0,88.8,277071,274050,245761,-31310,44.53
2022-11-09,3.46,85.79,286579,282140,259689,-26890,39.5
2022-11-10,4.8,86.52,282582,277040,261197,-21385,42.5
2022-11-14,6.24,85.85,297859,295560,264973,-32886,75.14
2022-11-15,5.9,86.87,317228,311190,284437,-32791,78.21
2022-11-16,5.88,85.62,321984,319800,286830,-35154,76.65
2022-11-17,6.2,81.69,315213,311560,279770,-35443,82.02
2022-11-18,6.1,80.07,316239,310580,282135,-34104,129.0
2022-11-21,6.23,79.74,338223,331110,292903,-45320,125.5
2022-11-22,6.27,80.83,317307,312080,274021,-43286,86.33
2022-11-28,6.0,77.1,302684,301600,271352,-31332,68.05
2022-11-29,6.03,77.96,322883,317770,285657,-37226,71.93
2022-11-30,7.0,80.48,328207,323620,290253,-37954,90.7
2022-12-01,6.33,81.06,324897,319860,278099,-46798,72.92
2022-12-02,4.92,79.86,320671,319600,274064,-46607,70.0
2022-12-07,4.49,71.93,315121,315910,254516,-60605,49.44
2022-12-08,4.79,71.3,309662,301430,250017,-59645,60.67
2022-12-12,6.73,72.96,364231,355080,283871,-80360,160.5
2022-12-14,6.54,77.14,357971,351390,289883,-68088,116.4
2022-12-15,6.8,75.89,351206,347420,279937,-71269,87.9
2022-12-19,6.08,75.05,349443,339140,285815,-63628,135.83
2022-12-20,5.28,75.92,345705,340730,289638,-56067,110.67
2022-12-21,6.13,78.17,351268,345780,289609,-61659,81.68
2022-12-22,7.1,77.68,354189,347550,303053,-51136,209.63
2022-12-27,4.88,79.45,351650,349470,308885,-42765,171.67
2022-12-28,4.06,78.89,350659,348910,286910,-63749,80.0
2022-12-29,3.78,78.43,323904,326080,250775,-73129,46.75
2022-12-30,3.52,80.16,302957,302250,247026,-55931,45.79
2023-01-03,3.64,76.87,335429,325680,261892,-73537,48.71
2023-01-04,3.75,72.82,323809,316390,253477,-70332,47.94
2023-01-05,3.78,73.61,324424,324410,268479,-55945,50.6
2023-01-09,3.65,74.69,338677,337060,271528,-67149,66.47
2023-01-10,3.32,75.11,336027,336370,271248,-64779,67.5
2023-01-11,3.41,77.46,344732,340970,276710,-68022,47.27
2023-01-12,3.47,78.32,351823,348190,295005,-56818,45.0
2023-01-17,3.43,80.25,327904,325520,262436,-65468,53.67
2023-01-18,3.2,79.53,320821,320670,265054,-55767,43.5
2023-01-19,2.91,80.31,335715,330920,267885,-67830,51.5
2023-01-23,3.43,81.62,350668,346720,279073,-71595,45.13
2023-01-24,3.35,79.86,346545,336120,273380,-73165,51.0
2023-01-25,3.09,79.78,351350,348200,285234,-66116,45.78
2023-01-26,2.72,80.64,331690,326600,263293,-68397,38.33
2023-01-30,2.82,77.97,315863,316310,257820,-58043,93.0
2023-01-31,2.65,78.95,337873,332640,262054,-75819,115.0
2023-02-01,2.65,76.34,348890,343150,268749,-80141,102.32
2023-02-02,2.67,75.87,349896,342950,264322,-85574,267.1
2023-02-06,2.17,74.11,337585,329150,270789,-66796,44.94
2023-02-07,2.35,77.17,339898,333790,285343,-54555,36.07
2023-02-08,2.4,78.47,324126,320300,268932,-55194,36.09
2023-02-09,2.4,78.04,332110,329010,281801,-50309,31.19
2023-02-13,2.42,80.14,313486,314700,255665,-57821,31.91
2023-02-14,2.42,79.08,301386,303830,238443,-62943,27.4
2023-02-15,2.45,78.57,307448,304970,251188,-56260,29.94
2023-02-16,2.48,78.45,294717,288800,244080,-50637,35.97
2023-02-21,2.12,76.28,321374,318980,260405,-60969,28.0
2023-02-22,2.07,73.95,319052,317710,264409,-54643,47.6
2023-02-23,2.17,75.26,350367,345640,288947,-61420,99.64
2023-02-27,2.55,75.57,339575,333630,265254,-74321,72.37
2023-02-28,2.5,76.88,353658,351660,280083,-73575,44.92
2023-03-01,2.59,77.57,329731,325240,261269,-68462,41.21
2023-03-02,2.67,78.05,332043,325460,270395,-61648,44.61
2023-03-06,2.46,80.39,296747,295880,256073,-40674,62.14
2023-03-08,2.5,76.56,314132,312840,271117,-43015,40.04
2023-03-09,2.5,75.6,301024,298290,263379,-37645,33.97
2023-03-10,2.4,76.55,291513,287910,265100,-26413,37.0
2023-03-13,2.4,74.68,321196,316140,294504,-26692,51.0
2023-03-14,2.65,71.18,329363,327950,287683,-41680,38.0
2023-03-15,2.45,67.38,319215,318010,286726,-32489,32.06
2023-03-20,2.23,67.56,293501,283650,268666,-24835,31.88
2023-03-21,1.93,69.4,285783,277100,264722,-21061,27.33
2023-03-22,2.03,70.71,276730,272540,259416,-17314,29.5
2023-03-23,2.08,69.77,294834,289710,274519,-20315,28.0
2023-03-27,2.04,72.87,275603,270790,260376,-15227,33.35
2023-03-28,2.02,73.12,296500,292850,277524,-18976,28.81
2023-03-29,1.94,72.95,275350,268370,252400,-22950,32.38
2023-03-30,1.95,74.32,285407,281930,263635,-21772,31.13
2023-04-03,2.09,80.4,273821,269680,240410,-33411,33.03
2023-04-04,2.13,80.7,266039,266870,233624,-32415,34.17
2023-04-05,2.17,80.69,291364,290730,261735,-29629,30.13
2023-04-06,2.18,80.7,283856,280700,246269,-37587,28.81
2023-04-10,2.15,79.79,254925,253530,222080,-32845,27.82
2023-04-11,2.19,81.54,258115,257470,224946,-33169,26.51
2023-04-12,2.22,83.26,253849,250950,221018,-32831,31.55
2023-04-13,2.04,82.16,267831,260810,227446,-40385,30.25
2023-04-14,1.87,82.58,275822,273880,241552,-34270,31.2
2023-04-17,2.21,80.93,276597,271940,248479,-28118,35.93
2023-04-18,2.23,80.85,262421,263610,229966,-32455,33.69
2023-04-19,2.2,79.18,272126,270100,236288,-35838,32.4
2023-04-20,2.19,77.27,254958,251490,224959,-29999,30.51
2023-04-24,2.19,78.64,263284,263670,235534,-27750,33.94
2023-04-25,2.21,77.05,258732,264590,227235,-31497,30.46
2023-04-26,2.19,74.33,260062,261750,227511,-32551,30.98
2023-04-27,2.17,74.77,266546,264440,235613,-30933,27.0
2023-05-01,2.24,75.65,260062,256410,220338,-39724,35.13
2023-05-02,2.12,71.71,271702,262400,225767,-45935,30.45
2023-05-03,2.01,68.62,271240,266120,232087,-39153,30.55
2023-05-04,1.96,68.52,279238,276970,239097,-40141,29.0
2023-05-08,2.12,73.13,253984,246170,231486,-22498,26.68
2023-05-09,2.22,73.68,245779,242840,218154,-27625,24.91
2023-05-10,2.12,72.53,249128,242140,213655,-35473,28.23
2023-05-11,2.07,70.81,261738,257590,231757,-29981,29.0
2023-05-12,1.98,70.02,271692,268840,241072,-30620,27.07
2023-05-15,2.25,71.07,255984,246380,229756,-26228,26.42
2023-05-16,2.28,70.85,262263,261160,243023,-19240,26.93
2023-05-17,2.25,72.78,249356,243620,222406,-26950,26.5
2023-05-22,2.3,71.81,251750,249230,236444,-15306,32.53
2023-05-23,2.22,72.87,250811,247960,216262,-34549,27.4
2023-05-24,2.25,74.37,261762,255110,225400,-36362,25.06
2023-05-30,2.11,69.45,254744,244690,223237,-31507,32.19
2023-05-31,2.1,68.11,272608,260930,235774,-36834,58.78
2023-06-01,1.77,70.09,310448,310290,261566,-48882,38.33
2023-06-05,1.92,72.14,271034,268450,230400,-40634,26.92
2023-06-06,1.95,71.71,270327,268070,236920,-33407,26.73
2023-06-07,2.13,72.52,274514,273590,233468,-41046,25.0
2023-06-08,2.1,71.28,272950,270890,232851,-40099,24.33
2023-06-09,1.85,70.16,266491,264720,233060,-33431,29.0
2023-06-12,1.9,67.08,307851,302680,266546,-41305,30.0
2023-06-13,2.0,69.39,316504,312770,267950,-48554,26.85
2023-06-14,2.05,68.22,303514,299730,249621,-53893,28.17
2023-06-15,2.18,70.61,300121,295740,250365,-49756,27.33
2023-06-16,2.13,71.81,307227,305610,258872,-48355,26.31
2023-06-20,2.38,70.94,285865,285420,253881,-31984,26.13
2023-06-21,2.24,72.55,284099,278400,248798,-35301,26.25
2023-06-22,2.27,69.22,284082,274760,258769,-25313,45.97
2023-06-23,2.22,68.91,310489,301590,269635,-40854,57.63
2023-06-26,2.62,69.09,367552,361070,294621,-72931,68.81
2023-06-27,2.68,67.68,359329,355670,270504,-88825,72.4
2023-06-29,2.4,69.85,345962,343600,260742,-85220,45.53
2023-06-30,2.48,70.66,343070,344430,284767,-58303,46.22
2023-07-05,2.65,71.78,383482,381260,346160,-37322,102.81
2023-07-06,2.5,71.76,431434,422370,366863,-64571,74.52
2023-07-07,2.49,73.91,415339,408390,339403,-75936,39.0
2023-07-10,2.55,73.05,369678,369230,338535,-31143,37.82
2023-07-11,2.57,74.87,371737,370230,336644,-35093,46.77
2023-07-12,2.55,75.77,410152,413450,382855,-27297,40.43
2023-07-13,2.5,76.86,415908,407610,388908,-27000,35.41
2023-07-17,2.46,74.17,415603,412090,370946,-44657,45.91
2023-07-18,2.52,75.76,413154,408920,366716,-46438,39.35
2023-07-19,2.51,75.4,388454,389530,359839,-28615,35.04
2023-07-20,2.61,75.65,374288,371610,353959,-20329,31.27
2023-07-21,2.61,77.06,367776,361090,347373,-20403,43.19
2023-07-24,2.68,78.81,389415,384040,363228,-26187,43.08
2023-07-25,2.66,79.76,393088,399980,357811,-35277,65.66
2023-07-26,2.6,79.11,393861,395490,339702,-54159,83.8
2023-07-27,2.47,80.17,429671,427050,362491,-67180,121.03
2023-07-28,2.53,80.55,434500,424230,380751,-53749,32.38
2023-07-31,2.58,81.8,322861,318490,278295,-44566,28.03
2023-08-01,2.49,81.37,314067,307060,287411,-26656,30.85
2023-08-02,2.43,79.5,301195,301300,273607,-27588,30.17
2023-08-03,2.44,81.56,314656,308930,289163,-25493,30.21
2023-08-07,2.65,81.94,345139,344560,316045,-29094,33.21
2023-08-08,2.77,82.94,375776,366200,327924,-47852,30.09
2023-08-09,2.92,84.35,356298,350170,310099,-46199,30.57
2023-08-10,2.83,82.81,355985,354370,314246,-41739,27.75
2023-08-14,2.74,82.5,360839,354720,321788,-39051,30.89
2023-08-15,2.65,81.06,356487,354680,315777,-40710,28.91
2023-08-16,2.55,79.4,343443,342910,311561,-31882,29.75
2023-08-17,2.56,80.43,342325,341910,307161,-35164,30.25
2023-08-21,2.6,80.71,364660,357380,318056,-46604,27.75
2023-08-23,2.6,78.91,303386,295140,265331,-38055,24.88
2023-08-24,2.42,79.52,306914,301890,269251,-37663,25.86
2023-08-28,2.6,80.65,329963,325970,290023,-39940,29.33
2023-08-29,2.5,81.14,346720,334520,303520,-43200,30.13
2023-08-30,2.48,81.64,363656,359740,312875,-50781,24.0
2023-09-01,2.7,85.52,276447,274140,231061,-45386,70.39
2023-09-05,2.6,86.74,414603,401910,370819,-43784,69.56
2023-09-06,2.49,87.55,437885,426390,376486,-61399,84.93
2023-09-07,2.45,86.87,452017,441690,389530,-62487,64.32
2023-09-08,2.53,87.51,425208,421830,365254,-59954,32.92
2023-09-11,2.5,87.3,366653,359270,323051,-43602,35.22
2023-09-12,2.72,88.87,364874,361560,314245,-50629,35.75
2023-09-14,2.81,90.13,313580,306620,274316,-39264,25.25
2023-09-15,2.74,90.83,279837,277800,240862,-38975,31.06
2023-09-18,2.54,91.47,313754,311490,281542,-32212,27.05
2023-09-19,2.46,91.16,288679,287840,276374,-12305,25.0
2023-09-20,2.78,89.2,276744,271860,261947,-14797,25.25
2023-09-21,2.7,89.56,272116,268050,260459,-11657,25.5
2023-09-27,2.72,93.67,262196,259060,256733,-5463,27.0
2023-09-28,2.74,91.65,268040,264850,259925,-8115,28.59
2023-09-29,2.68,90.77,289592,285520,281695,-7897,32.07
2023-10-02,2.7,88.81,270410,269810,262706,-7704,35.28
2023-10-03,2.71,89.26,284462,281900,262119,-22343,30.04
2023-10-04,2.92,84.32,304982,303470,279272,-25710,29.05
2023-10-05,2.92,82.3,298615,292830,269574,-29041,27.36
2023-10-10,3.34,85.89,274914,276430,237579,-37335,29.61
2023-10-11,3.19,83.7,274544,269400,237402,-37142,28.3
2023-10-12,3.16,82.87,269857,266800,232201,-37656,25.35
2023-10-16,2.98,86.65,277270,276580,262636,-14634,28.25
2023-10-17,2.94,86.66,277072,272290,271099,-5973,26.1
2023-10-18,2.92,88.35,282624,279180,264233,-18391,28.54
2023-10-19,2.84,89.35,270830,269960,251614,-19216,31.06
2023-10-23,2.65,85.49,272052,271690,252049,-20003,26.81
2023-10-24,2.85,84.58,277213,273720,264917,-12296,27.62
2023-10-25,2.86,86.07,275351,270610,259517,-15834,29.15
2023-10-26,2.87,83.8,276282,273500,271298,-4984,33.0
2023-10-27,3.24,86.04,276138,278760,264996,-11142,41.92
2023-10-30,3.17,83.03,295503,293800,273192,-22311,45.79
2023-10-31,3.34,81.64,275354,275950,252256,-23098,54.89
2023-11-01,3.19,81.05,302148,301130,245875,-56273,40.02
2023-11-02,3.12,83.04,295849,292240,244866,-50983,31.07
2023-11-03,3.0,81.19,286115,282790,230743,-55372,33.6
2023-11-06,2.71,81.54,293367,290000,240515,-52852,29.86
2023-11-07,2.0,77.96,287062,283750,245762,-41300,32.13
2023-11-08,2.18,75.85,288886,285210,260768,-28118,35.93
2023-11-09,2.71,76.34,322609,320700,275701,-46908,33.71
2023-11-13,2.61,78.86,315139,311990,271615,-43524,40.28
2023-11-14,2.69,78.9,312104,311260,266212,-45892,36.17
2023-11-15,2.88,77.15,304842,301680,274337,-30505,33.07
2023-11-16,2.91,73.5,291561,286960,260167,-31394,31.21
2023-11-20,2.49,78.1,312669,311120,255005,-57664,44.0
2023-11-21,2.63,78.35,331054,325810,263807,-67247,37.05
2023-11-22,2.72,76.8,323371,323150,251521,-71850,47.13
2023-11-27,2.74,74.46,302799,301810,235048,-67751,74.55
2023-11-28,2.78,76.09,329712,324350,243054,-86658,92.89
2023-11-29,2.7,77.56,344051,340750,248398,-95653,50.13
2023-11-30,2.75,75.66,327003,323040,243718,-83285,38.46
2023-12-01,2.63,73.7,313611,311620,263159,-50452,37.25
2023-12-04,2.55,72.73,315518,313370,255464,-60054,63.94
2023-12-05,2.72,71.95,336047,332630,275159,-60888,123.55
2023-12-06,2.76,68.98,350099,348780,289969,-60130,102.11
2023-12-07,2.52,69.0,364016,357870,303507,-60509,51.68
2023-12-08,2.57,70.87,337814,335330,274633,-63181,38.94
2023-12-11,2.39,70.95,323176,318320,282498,-40678,39.47
2023-12-12,2.37,68.27,327244,321320,260589,-66655,41.71
2023-12-13,2.33,69.09,332745,329570,266476,-66269,41.79
2023-12-14,2.39,71.21,346673,341250,281649,-65024,30.84
2023-12-15,2.44,71.05,322471,321500,267890,-54581,32.0
2023-12-18,2.59,72.16,306011,305210,254538,-51473,38.58
2023-12-19,2.44,73.23,310803,308210,252212,-58591,37.05
2023-12-20,2.48,73.87,331175,326920,276084,-55091,48.61
2023-12-21,2.48,73.59,342119,335980,271374,-70745,54.0
